pBFCCCCCCCCCCCCCLxBECAC
BBBCCDDDCCDCCCCCBBBBBBB
JJBBCDCCCDDDCBExBBCCCBB
CCCBCDDDCCDCCBBBBBCCCBB
CCCBCCCCCCCCCJBBBBCBBBB
CCCBCBBBCCCCCJJBBBCBBJJ
CCCBBBCBCCCCCCCBCCCBBJJ
CCCCCCCBCxCCDCCBCxBBBBB
@BBCCCCBBBCDDDCBCBBBBBG
BHBCCCCCCBCCDCCBCBBCCCC
BBBCCCCCCBCCCCCBC@BCCCC
CBCCCCCCCBJCCCCBCCCCB@C
CBBBBBBBBBBBBBBBBBBBBBC
CCCCCCCCCCCCCCCCCCCCCCC
assets/environment component themes/test theme2/
