•ƒ‰““”…
•‰”¢¡ ’”
ƒ‘£¤¥¢
•‘¦§¨†Ÿ
–‹©€ªœ
••‹„&—
ËÌÍ‘
ÏÐÑ‹
•ƒ•‰”¢¡ ¢¡
assets/environment component themes/test theme2/
