HHHHHHHHHHHHHHDDDDJJJJJ
HHHHHHHHB@HHHHDDDDDJJJJ
HBBBBBBBBBHHHHDDDDDDDDJ
HBBHHHHCHCHCHHDDDDJDDDJ
HBHCCHHCCCCCBBCCJJJJDJJ
HBCCCCCCCCCCCCCCCBDJDJJ
HBCCCCCCCACCCCCCCBDJDJJ
HBBBBGBxBBExBBBBBBDDDDD
HBBBBBBBBBBBBBBBBBDDDDD
HBBBBBBBBBBBBBBBBBDJJJJ
HBBBBBBBBBBBBBBBBBDJBBB
HBBBBBBDDBBBBBBBBJJJBBB
HBBBBDDDDBBBBBBBBBBBBBp
FBBDDDDDDDDDDDDBBBBBBBB
assets/environment component themes/test theme2/
